111111111111111111111111111111111111111111111111
111111111111111111001111111111111111111111111111
111111111111111111000111111111111111111111111111
111111111111111111C0011111111111111111111111E111
111111111111111111P00111111111111111111111111111
111111111111111111111111111111111111111111111111
111111111111111111111111111111111111111111111111111
